{
	"map":
	[
		[
			"####################################################################",
			"d..................................................................#",
			"#..................................................................#",
			"#..................................................................#",
			"#####################################################d##############"
		],
		[
			"####################################################################",
			"#                                                                  #",
			"#                                                                  #",
			"#                                                                  #",
			"####################################################################"
		]
	],
	"reference":
	{
		"#":"wall",
		".":"floor",
		"<":"upstairs",
		">":"downstairs",
		"0":"door",
		" ":"open space",
		"w":"water"
	}
}
